1111111111111111111111111
1000000111000000000000111
10000C0010010100000000011
10C0111000010011111110011
1C00001110010011111000011
10000C100010101C000010011
1CC0CC1001011001111111011
11C0001111010010C00000011
1000001000100011111111111
1000C01010000011111111111
10000C1011110000000000001
10P0C000111111111000000E1
1111111111111111111111111
