1111111111
1000000001
1000000001
1000000001
100000C001
1000000001
10C0000001
1000000001
1000000001
1000000001
1000000001
1000100001
1000000001
100000C001
100000C001
1000000001
100C000001
1P0C0E0001
1C0C100001
1111111111
