11111111
10000001
1C000001
10000CC1
100000C1
100C0001
1C0C1EC1
1C010001
100C1P01
10000001
11111111
